WWWWWWWWWWWWWWWWWWWW
WWWWWWWW..........WW
WWWWW..E..WWWWWWW.WW
WWWW.........WWWW.WW
W...P.*.........W.WW
WWWW.....E........WW
WWWWWWWWWWWWWWWWWWWW