WWWWWWWWWWW
WWWWWWWWWWW
WWWWW.....W
W........WW
W...P.*...W
WE........W
WWWWWWWWWWW