WWWWWWWWWWWWWWWWWWWW
W.................WW
W.WWW..E..WWWWWWW.WW
W.WW.........WWWW.WW
W...P.*.........W.WW
WWWW.....E........WW
WWWWWWWWWWWWWWWWWWWW