WWWWWWWWWWWWWWWWWWWW
WWWWWWWW..........WW
WWWWW.....WWWWWWW.WW
WWWW.........WWWW.WW
W...P.*.........W.WW
WWWW..............WW
WWWWWWWWWWWWWWWWWWWW