WWWWWWWWWWW
WWWWWWWWWWW
WWWWWP....W
W.........W
W.....*...W
WE........W
WWWWWWWWWWW