WWWWWWWWWWWWWWWWWWWWWWWWWWWW
W............WW............W
W.WWWW.WWWWW.WW.WWWWW.WWWW.W
W*WWWW.WWWWW.WW.WWWWW.WWWW*W
W.WWWW.WWWWW.WW.WWWWW.WWWW.W
W..........................W
W.WWWW.WW.WWWWWWWW.WW.WWWW.W
W.WWWW.WW.WWWWWWWW.WW.WWWW.W
W......WW....WW....WW......W
WWWWWW.WWWWW WW WWWWW.WWWWWW
WWWWWW.WWWWW WW WWWWW.WWWWWW
WWWWWW.WW          WW.WWWWWW
WWWWWW.WW          WW.WWWWWW
WWWWWW.WW          WW.WWWWWW
WWWWWW.              .WWWWWW
WWWWWW.      QP      .WWWWWW
WWWWWW.WW          WW.WWWWWW
WWWWWW.WW          WW.WWWWWW
WWWWWW.WW          WW.WWWWWW
WWWWWW.WW WWWWWWWW WW.WWWWWW
WWWWWW.WW WWWWWWWW WW.WWWWWW
W............WW............W
W.WWWW.WWWWW.WW.WWWWW.WWWW.W
W.WWWW.WWWWW.WW.WWWWW.WWWW.W
W*..WW................WW..*W
WWW.WW.WW.WWWWWWWW.WW.WW.WWW
WWW.WW.WW.WWWWWWWW.WW.WW.WWW
W......WW....WW....WW......W
W.WWWWWWWWWW.WW.WWWWWWWWWW.W
W.WWWWWWWWWW.WW.WWWWWWWWWW.W
W..........................W
WWWWWWWWWWWWWWWWWWWWWWWWWWWW