MMMMMMMMM
M.......M
MMMMMM..M
MP....E.M
MMMMMMMMM