WWWWWWWWW
W.......W
WWWWWW..W
WP....E.W
WWWWWWWWW